														Dictinary
Expose - подвергать, разоблачать, выставлять, раскрывать/
acted upon  - действует
underluing - лежащий в основе
to mandate - поручать, требовать
a particular data persistence - какой-либо конкретный формат данных
a particular - конкретный
a batch - партия, пакет, серия.
the remainder - остаток, +of - остальная часть
a brief коротко, + description  -короткое описание
association - обьединение, связь, ассоциация
subset - подмножество
to instance - ссылаться/служить примером
to outline - в общих чертах, сделать набросок, обрисовать, очерчивать
outline (сущ)  - план, схема, контур, набросок.
to rely(2ф relied)  - полагаться, надеется, зависеть
obligation - обязательство, долг, обязанность
to pursue - преследовать, гнаться за, продолжать ,следовать по намеченному пути
mentioned - упомянутый 
warranty - гарантия, ручительство, основание
to imply - подразумевать, означать, предпологать, значить, заключать в себе
merchantability - товарность
fitness - пригоность, приспособленность, годность /фитнесс
infrigement - нарушение
assume - предпологать, принимать, брать на себя, допускать, присваивать 
enhancement - улучшение, усиление, совершенствование
rating - номинал, рейтинг, разряд
maintenance - поддержание, обслуживание уход, сопровождение, техобслуживание, эксплуатация
landscape - ландшафт, пейзаж
to offer - предлагать, возносить, выдвигать, предлогать вниманию
guidance - руководство, управление, совет.
to occur - случаться, иметь место, происходить
consider - рассматривать, учитывать, считать 
consideration - внмиание, рассмотрение, соображение
trade-off - компромисс, взаимные уступки
impact  - влияние(3), толчок(1), воздействие (3)
to impact - ударять, сталкиваться, плотно сжимать, прочно укреплять (1)
interaction  - взаимеодействие
on-premise - локально, на месте ( не на SCP)
gathering - сбор, встреча, собирание, сбор
blueprint - план, проект



